9 22
|--------------------|
|...|.F-.|...........|
|..-|.F.F|...........|
|.....-..|...........|
|................P...|
|.............-......|
|...........@........|
|...............-....|
|--------------------|