5 10

.........
....|....
....|....
....|..@.
.........