5 10

|--------|
|...|..-.|
|..-|....|
|.....@..|
|--------|
