5 10

|--------|
|...|..-.|
|..-|....|
|....@...|
|--------|
